F,F,F,F,F,F,F,F,F,F,F,F,F,F,F,F,F,F,F,F,F
M,F,F,F,F,G,G,F,F,F,F,F,F,F,F,F,F,F,F,F,F
M,M,F,F,G,G,G,G,G,F,F,F,F,F,F,F,F,F,F,G,G
M,M,M,G,G,G,G,G,G,G,F,F,F,F,F,F,F,F,G,G,G
M,M,G,G,G,G,G,G,G,G,G,F,F,F,F,F,G,G,G,G,G
M,S,W,W,W,W,G,G,G,G,G,G,F,F,F,G,G,G,G,W,W
S,S,S,W,W,W,W,W,W,W,G,G,G,F,G,G,G,G,W,W,W
S,S,S,S,W,W,W,W,W,W,W,G,G,G,G,G,G,W,W,W,W
S,S,S,W,W,W,G,G,W,W,W,G,G,G,G,G,G,W,W,W,W
S,S,W,W,W,W,W,W,W,W,W,G,G,G,G,G,G,G,W,W,W
S,S,S,S,W,W,W,W,W,W,G,G,G,G,G,G,G,G,G,W,W
S,S,S,S,S,S,S,G,G,G,G,G,G,G,G,G,G,G,G,G,W