1,1,1,1,1,1,2,2,2,2,2,2,2,7,7,7,10,10,10,10,10
1,1,1,1,1,3,2,2,2,2,2,2,2,7,7,7,10,10,10,10,10
1,1,1,1,3,3,2,2,2,2,7,7,7,7,7,7,7,7,10,10,10
1,1,1,3,3,3,2,2,2,2,7,7,7,7,7,11,11,7,10,10,10
1,1,3,3,3,3,2,2,2,2,6,6,7,7,7,11,11,11,11,11,10
1,4,3,3,3,3,2,2,2,2,6,6,6,6,7,11,11,11,11,10,10
4,4,3,3,3,3,3,6,6,6,6,6,6,6,8,8,9,9,10,10,10
4,4,3,3,3,3,3,6,6,6,6,6,6,6,8,8,9,9,9,10,10
4,4,4,4,4,3,3,5,5,5,5,8,8,8,8,8,9,9,9,9,10
4,4,4,4,4,5,5,5,5,5,5,8,8,8,8,8,9,9,9,9,9
4,4,4,4,4,5,5,5,5,5,5,8,8,8,8,9,9,9,9,9,9
4,4,4,4,4,5,5,5,5,5,5,8,8,8,8,9,9,9,9,9,9