F,F,F,F,F,F,F,F,F,F,F,F,F,F
M,F,F,F,F,G,G,F,F,F,F,F,F,F
M,M,F,F,G,G,G,G,G,F,F,F,F,F
M,M,M,G,G,G,G,G,G,G,F,F,F,F
M,M,G,G,G,G,G,G,G,G,G,F,F,F
M,D,W,W,W,W,G,G,G,G,G,G,F,F
D,D,D,W,W,W,W,W,W,W,G,G,G,F
D,D,D,D,W,W,W,W,W,W,W,G,G,G
D,D,D,W,W,W,G,G,W,W,W,G,G,G
D,D,W,W,W,W,W,W,W,W,W,G,G,G
D,D,D,D,W,W,W,W,W,W,G,G,G,G
D,D,D,D,D,D,D,G,G,G,G,G,G,G