F,F,F,F,F,F,F,F,F,F,F,F,F,F,F,F,F,F,F,F,F
M,F,F,F,F,G,G,F,F,F,F,F,F,F,F,F,F,F,F,F,F
M,M,F,F,G,G,G,G,G,F,F,F,F,F,F,F,F,F,F,G,G
M,M,M,G,G,G,G,G,G,G,F,F,F,F,F,F,F,F,G,G,G
M,M,G,G,G,G,G,G,G,G,G,F,F,F,F,F,G,G,G,G,G
M,D,W,W,W,W,G,G,G,G,G,G,F,F,F,G,G,G,G,W,W
D,D,D,W,W,W,W,W,W,W,G,G,G,F,G,G,G,G,W,W,W
D,D,D,D,W,W,W,W,W,W,W,G,G,G,G,G,G,W,W,W,W
D,D,D,W,W,W,G,G,W,W,W,G,G,G,G,G,G,W,W,W,W
D,D,W,W,W,W,W,W,W,W,W,G,G,G,G,G,G,G,W,W,W
D,D,D,D,W,W,W,W,W,W,G,G,G,G,G,G,G,G,G,W,W
D,D,D,D,D,D,D,G,G,G,G,G,G,G,G,G,G,G,G,G,W