W,W,W,W,W,W,W,W,W,W,W,W,W,W,W,W,W,W,W,W,W,W,W,W,W,W,W,W,W,W,W,W,W,W,W,W,W,W,W,W,W,W,W,W,W,W,W,W,W,W,W,W,W,W
W,W,W,W,W,W,W,W,W,W,W,W,W,W,W,W,W,W,W,W,W,W,W,W,W,W,W,W,W,W,W,W,W,W,W,W,W,W,W,W,W,W,W,W,W,W,W,W,W,W,W,W,W,W
W,W,W,W,W,W,W,W,W,S,S,S,S,S,S,S,S,S,S,S,S,S,S,S,S,S,S,S,S,S,S,S,S,S,S,S,S,S,S,S,S,S,S,W,W,W,W,W,W,W,W,W,W,W
W,W,W,W,W,W,S,S,S,S,S,S,S,S,S,S,S,S,S,S,S,S,S,S,S,S,S,S,S,S,S,S,S,S,S,S,S,S,S,S,S,S,S,S,S,S,W,W,W,W,W,W,W,W
W,W,W,W,S,S,S,S,S,S,S,S,S,S,S,S,S,S,S,S,S,S,S,S,S,S,S,S,S,S,S,S,S,S,S,S,S,S,S,S,S,S,S,S,S,S,S,S,S,W,W,W,W,W
W,W,W,W,S,S,S,S,S,S,S,S,S,S,S,G,G,G,G,G,G,G,G,G,G,G,G,G,G,G,G,G,G,G,S,S,S,S,S,S,S,S,S,S,S,S,S,S,S,S,S,W,W,W
W,W,W,S,S,S,S,S,S,G,G,G,G,G,G,G,G,G,G,G,G,G,G,G,G,G,G,G,G,G,G,G,G,G,G,G,G,G,G,G,G,S,S,S,S,S,S,S,S,S,S,W,W,W
W,W,W,S,S,S,S,G,G,G,G,G,G,G,G,H,H,H,H,H,H,H,H,H,H,H,H,H,G,G,G,G,H,H,H,H,H,G,G,G,G,G,G,G,G,G,G,G,S,S,W,W,W,W
W,W,W,W,S,S,G,G,H,H,H,H,H,H,H,H,H,H,G,G,G,G,G,G,H,H,H,H,H,H,G,G,G,G,G,G,H,H,H,H,H,H,G,G,G,S,S,S,W,W,W,W,W,W
W,W,W,W,W,S,S,G,G,H,H,H,H,H,H,H,M,M,M,M,M,M,M,M,M,H,H,H,M,M,M,M,M,M,H,H,H,H,H,M,M,M,H,H,H,G,G,S,S,S,W,W,W,W
W,W,W,W,S,S,S,G,G,G,H,H,H,H,M,M,M,M,M,M,M,M,M,M,M,M,H,M,M,M,M,M,M,M,M,H,H,H,M,M,M,M,M,H,H,G,G,G,S,S,S,W,W,W
W,W,W,S,S,G,G,G,G,H,H,H,H,M,M,M,M,M,M,M,M,M,M,M,M,M,M,M,M,M,M,M,M,M,M,M,H,M,M,M,M,M,M,M,H,H,G,G,S,S,W,W,W,W
W,W,W,S,S,S,G,G,G,G,H,H,M,M,M,M,M,M,I,I,M,M,M,M,M,M,M,M,M,M,M,M,M,M,M,M,M,M,M,M,M,M,M,M,M,H,H,G,G,S,S,S,W,W
W,W,S,S,G,G,G,G,H,H,H,M,M,M,M,M,M,I,I,I,I,M,M,M,M,M,M,M,M,I,I,I,I,M,M,M,M,M,M,I,I,I,M,M,M,M,H,H,G,G,S,S,W,W
W,W,S,S,G,G,G,G,H,H,H,M,M,M,M,M,I,I,I,I,I,I,M,M,M,M,M,M,I,I,I,I,I,I,M,M,M,M,I,I,I,I,I,M,M,M,H,H,G,G,S,S,W,W
W,W,S,S,G,G,G,H,H,H,H,M,M,M,M,I,I,I,I,I,I,I,I,M,M,M,M,I,I,I,I,I,I,I,I,M,M,I,I,I,I,I,I,I,M,M,M,H,H,G,G,S,W,W
W,W,S,S,S,G,G,G,H,H,H,M,M,M,I,I,I,I,I,I,I,I,I,I,M,M,I,I,I,I,I,I,I,I,I,I,M,M,I,I,I,I,I,M,M,M,H,H,H,G,G,S,S,W
W,W,S,S,G,G,G,H,H,H,H,M,M,M,M,I,I,I,I,I,I,I,I,M,M,M,M,I,I,I,I,I,I,I,I,M,M,M,M,I,I,I,M,M,M,H,H,H,H,G,S,S,W,W
W,W,W,W,S,S,G,G,H,H,H,M,M,M,M,M,I,I,I,I,I,I,M,M,M,M,M,M,I,I,I,I,I,I,M,M,M,M,M,M,I,M,M,M,H,H,H,H,G,G,G,S,W,W
W,W,W,S,S,S,G,G,G,H,H,H,M,M,M,M,M,I,I,I,I,M,M,M,M,M,M,M,M,I,I,I,I,M,M,M,M,M,M,M,M,M,M,H,H,H,H,G,G,G,S,S,W,W
W,W,W,W,S,S,S,S,S,H,H,H,H,M,M,M,M,M,I,I,M,M,M,M,M,M,M,M,M,M,I,I,M,M,M,M,M,M,M,M,M,M,H,H,H,H,H,G,G,S,S,W,W,W
W,W,W,S,S,S,W,W,S,G,H,H,H,H,M,M,M,M,M,M,M,M,M,M,M,M,M,M,M,M,M,M,M,M,M,M,M,M,M,M,H,H,H,H,H,H,G,G,G,S,S,W,W,W
W,W,S,S,W,W,W,W,W,S,G,H,H,H,H,M,M,M,M,M,M,M,M,M,M,H,M,M,M,M,M,M,M,M,M,M,M,H,H,H,H,H,G,G,G,G,S,S,S,S,S,W,W,W
W,W,S,S,W,W,W,W,S,S,G,H,H,H,H,H,M,M,M,M,M,M,M,M,H,H,H,M,M,M,M,M,M,M,M,M,H,H,H,H,G,G,G,G,G,G,S,S,S,S,S,S,W,W
W,W,S,S,S,W,W,W,W,S,S,G,G,H,H,H,H,M,M,M,M,M,M,H,H,H,H,H,M,M,M,M,M,M,M,H,H,H,G,G,G,G,G,G,G,G,G,S,S,S,S,W,W,W
W,W,W,S,S,W,W,W,S,S,G,G,G,G,H,H,H,H,M,M,M,H,H,H,H,H,H,H,H,M,M,M,M,H,H,H,H,G,G,G,G,G,G,G,G,G,S,S,S,S,W,W,W,W
W,W,W,W,S,S,W,S,S,G,G,G,G,G,G,G,H,H,H,H,H,H,H,H,H,H,H,H,H,H,H,H,H,H,H,G,G,G,G,G,G,G,G,S,S,S,S,W,W,W,W,W,W,W
W,W,W,W,W,S,S,S,S,S,S,S,S,S,G,G,G,G,G,G,G,G,G,G,G,G,G,G,G,G,G,G,G,G,G,G,G,G,G,S,S,S,S,S,W,W,W,W,W,W,W,W,W,W
W,W,W,W,W,W,W,W,S,S,S,S,S,S,S,S,S,S,S,S,S,S,S,G,G,G,G,G,G,G,G,G,G,S,S,S,S,S,S,S,S,W,W,W,W,W,W,W,W,W,W,W,W,W
W,W,W,W,W,W,W,W,W,W,W,S,S,S,S,S,S,S,S,S,S,S,S,S,S,S,S,S,S,S,S,S,S,S,S,S,W,W,W,W,W,W,W,W,W,W,W,W,W,W,W,W,W,W
W,W,W,W,W,W,W,W,W,W,W,W,W,W,W,W,W,W,W,W,W,W,W,W,W,W,W,W,W,W,W,W,W,W,W,W,W,W,W,W,W,W,W,W,W,W,W,W,W,W,W,W,W,W