F,F,F,F,F,F,F,F,F,F,F,F,F,F,F,F,F,F,F,F,F,F,F,F,F,F,W,W,W,W,W,W,W,W,W,W,W,W,W,W,W,W,W,W,W,W,W,W,W,W,W,W,W,W
M,F,F,F,F,G,G,F,F,F,F,F,F,F,F,F,F,F,F,F,F,F,F,G,G,W,W,W,W,W,W,W,W,W,W,W,W,W,W,W,W,W,W,W,W,W,W,W,W,W,W,W,W,W
M,M,F,F,G,G,G,G,G,F,F,F,F,F,F,F,F,F,F,G,G,G,G,G,W,W,W,W,W,W,W,W,W,W,W,W,W,W,W,W,W,W,W,W,W,W,W,W,W,W,W,W,W,W
M,M,M,G,G,G,G,G,G,G,F,F,F,F,F,F,F,F,G,G,G,G,G,W,W,W,W,W,W,W,W,W,W,W,W,W,W,W,W,W,W,W,W,W,W,W,W,W,W,W,W,W,W,W
M,M,G,G,G,G,G,G,G,G,G,F,F,F,F,F,G,G,G,G,G,W,W,W,W,W,W,W,W,W,W,W,W,W,W,W,W,W,W,W,W,W,W,W,W,W,W,W,W,W,W,W,W,W
M,S,W,W,W,W,G,G,G,G,G,G,F,F,F,G,G,G,G,W,W,W,W,W,W,W,W,W,W,W,W,W,W,W,W,W,W,W,W,W,W,W,W,W,W,W,W,W,W,W,W,W,W,W
S,S,S,W,W,W,W,W,W,W,G,G,G,F,G,G,G,G,W,W,W,W,W,W,W,W,W,W,W,W,W,W,W,W,W,W,W,W,W,W,W,W,W,W,W,W,W,W,W,W,W,W,W,W
S,S,S,S,W,W,W,W,W,W,W,G,G,G,G,G,G,W,W,W,W,W,W,W,W,W,W,W,W,W,W,W,W,W,W,W,W,W,W,W,W,W,W,W,W,W,W,W,W,W,W,W,W,W
S,S,S,W,W,W,G,G,W,W,W,G,G,G,G,G,G,W,W,W,W,W,W,W,W,W,W,W,W,W,W,W,W,W,W,W,W,W,W,W,W,W,W,W,W,W,W,W,W,W,W,W,W,W
S,S,W,W,W,W,W,W,W,W,W,G,G,G,G,G,G,G,W,W,W,W,W,W,W,W,W,W,W,W,W,W,W,W,W,W,W,W,W,W,W,W,W,W,W,W,W,W,W,W,W,W,W,W
S,S,S,S,W,W,W,W,W,W,G,G,G,G,G,G,G,G,G,W,W,W,W,W,W,W,W,W,W,W,W,W,W,W,W,W,W,W,W,W,W,W,W,W,W,W,W,W,W,W,W,W,W,W
S,S,S,S,S,S,S,G,G,G,G,G,G,G,G,G,G,G,G,G,W,W,W,W,W,W,W,W,W,W,W,W,W,W,W,W,W,W,W,W,W,W,W,W,W,W,W,W,W,W,W,W,W,W
W,W,W,W,W,W,W,G,G,W,W,W,W,W,W,W,W,W,W,W,W,W,W,W,W,W,W,W,W,W,W,W,W,W,W,W,W,W,W,W,W,W,W,W,W,W,W,W,W,W,W,W,W,W
W,W,W,W,W,W,W,G,G,W,W,W,W,W,W,W,W,W,W,W,W,W,W,W,W,W,W,W,W,W,W,W,W,W,W,W,W,W,W,W,W,W,W,W,W,W,W,W,W,W,W,W,W,W
W,W,W,W,W,W,G,G,G,W,W,W,G,W,W,G,W,W,W,W,W,W,W,W,W,W,W,W,W,W,W,W,W,W,W,W,W,W,W,W,W,W,W,W,W,W,W,W,W,W,W,W,W,W
W,W,W,W,G,G,G,G,G,G,G,G,G,G,G,G,G,G,W,W,W,W,W,W,W,W,W,W,W,W,W,W,W,W,W,W,W,W,W,W,W,W,W,W,W,W,W,W,W,W,W,W,W,W
W,W,W,G,G,G,G,G,G,G,G,G,G,G,G,G,G,G,G,W,W,W,W,W,W,W,W,W,W,W,W,W,W,W,W,W,W,W,W,W,W,W,W,W,W,W,W,W,W,W,W,W,W,W
W,W,G,G,G,G,G,G,G,G,G,G,G,G,G,G,G,G,G,G,G,G,W,W,W,W,W,W,W,W,W,W,W,W,W,W,W,W,W,W,W,W,W,W,W,W,W,W,W,W,W,W,W,W
W,G,G,G,G,G,G,G,G,G,G,G,G,G,G,G,G,G,G,G,G,G,G,W,W,W,W,W,W,W,W,W,W,W,W,W,W,W,W,W,W,W,W,W,W,W,W,W,W,W,W,W,W,W
W,G,G,G,G,G,G,G,G,G,G,G,G,G,G,G,G,G,G,G,G,G,G,G,W,W,W,W,W,W,W,W,W,W,W,W,W,W,W,W,W,W,W,W,W,W,W,W,W,W,W,W,W,W
W,G,G,G,G,G,G,G,G,G,G,G,G,G,G,G,G,G,G,G,G,G,G,W,W,W,W,W,W,W,W,W,W,W,W,W,W,W,W,W,W,W,W,W,W,W,W,W,W,W,W,W,W,W
W,G,G,G,G,G,G,G,G,G,G,G,G,G,G,G,G,G,G,G,W,W,G,G,W,W,W,W,W,W,W,W,W,W,W,W,W,W,W,W,W,W,W,W,W,W,W,W,W,W,W,W,W,W
W,W,G,G,G,G,G,G,G,G,G,G,G,G,G,G,G,G,G,W,W,W,G,G,W,W,W,W,W,W,W,W,W,W,W,W,W,W,W,W,W,W,W,W,W,W,W,W,W,W,W,W,W,W
W,W,W,G,G,G,G,G,G,G,G,G,G,G,G,G,G,G,W,W,W,W,W,W,W,W,W,W,W,W,W,W,W,W,W,W,W,W,W,W,W,W,W,W,W,W,W,W,W,W,W,W,W,W
W,W,W,W,G,G,G,G,G,G,G,G,G,G,G,G,G,G,W,W,W,W,W,W,W,W,W,W,W,W,W,W,W,W,W,W,W,W,W,W,W,W,W,W,W,W,W,W,W,W,W,W,W,W
W,W,W,W,W,G,G,G,G,G,G,G,G,G,G,G,W,W,W,W,W,W,W,W,W,W,W,W,W,W,W,W,W,W,W,W,W,W,W,W,W,W,W,W,W,W,W,W,W,W,W,W,W,W
W,W,W,W,W,W,W,G,G,G,G,G,G,G,G,W,W,W,W,W,W,W,W,W,W,W,W,W,W,W,W,W,W,W,W,W,W,W,W,W,W,W,W,W,W,W,W,W,W,W,W,W,W,W
W,W,W,W,W,W,W,W,W,W,G,G,W,W,W,W,W,W,W,W,W,W,W,W,W,W,W,W,W,W,W,W,W,W,W,W,W,W,W,W,W,W,W,W,W,W,W,W,W,W,W,W,W,W
W,W,W,W,W,W,W,W,W,W,W,G,G,W,W,W,W,W,W,W,W,W,W,W,W,W,W,W,W,W,W,W,W,W,W,W,W,W,W,W,W,W,W,W,W,W,W,W,W,W,W,W,W,W
W,W,W,W,W,W,W,W,W,G,G,G,G,G,W,W,W,W,W,W,W,W,W,W,W,W,W,W,W,W,W,W,W,W,W,W,W,W,W,W,W,W,W,W,W,W,W,W,W,W,W,W,W,W
W,W,W,W,W,W,W,W,G,G,G,G,G,G,G,W,W,W,W,W,W,W,W,W,W,W,W,W,W,W,W,W,W,W,W,W,W,W,W,W,W,W,W,W,W,W,W,W,W,W,W,W,W,W
W,W,W,W,W,W,G,G,G,G,G,G,G,G,G,G,W,W,W,W,W,W,W,W,W,W,W,W,W,W,W,W,W,W,W,W,W,W,W,W,W,W,W,W,W,W,W,W,W,W,W,W,W,W
W,W,W,W,W,W,W,G,G,G,G,G,G,G,G,G,G,W,W,W,W,W,W,W,W,W,W,W,W,W,W,W,W,W,W,W,W,W,W,W,W,W,W,W,W,W,W,W,W,W,W,W,W,W
W,W,W,W,W,W,W,W,G,G,G,G,G,G,G,G,G,G,W,W,W,W,W,W,W,W,W,W,W,W,W,W,W,W,W,W,W,W,W,W,W,W,W,W,W,W,W,W,W,W,W,W,W,W
W,W,W,W,W,W,W,W,W,G,G,G,G,G,G,G,G,G,W,W,W,W,W,W,W,W,W,W,W,W,W,W,W,W,W,W,W,W,W,W,W,W,W,W,W,W,W,W,W,W,W,W,W,W
W,W,W,W,W,W,W,W,W,W,W,G,G,G,G,G,G,W,W,W,W,W,W,W,W,W,W,W,W,W,W,W,W,W,W,W,W,W,W,W,W,W,W,W,W,W,W,W,W,W,W,W,W,W
W,W,W,W,W,W,W,W,W,W,W,W,G,G,G,G,W,W,W,W,W,W,W,W,W,W,W,W,W,W,W,W,W,W,W,W,W,W,W,W,W,W,W,W,W,W,W,W,W,W,W,W,W,W
W,W,W,W,W,W,W,W,W,W,W,W,G,G,G,G,W,W,W,W,W,W,W,W,W,W,W,W,W,W,W,W,W,W,W,W,W,W,W,W,W,W,W,W,W,W,W,W,W,W,W,W,W,W
W,W,W,W,W,W,W,W,W,W,W,W,G,G,G,G,W,W,W,W,W,W,W,W,W,W,W,W,W,W,W,W,W,W,W,W,W,W,W,W,W,W,W,W,W,W,W,W,W,W,W,W,W,W
W,W,W,W,W,W,W,W,W,W,W,W,W,G,G,W,W,W,W,W,W,W,W,W,W,W,W,W,W,W,W,W,W,W,W,W,W,W,W,W,W,W,W,W,W,W,W,W,W,W,W,W,W,W
W,W,W,W,W,W,W,W,W,W,W,W,W,W,W,W,W,W,W,W,W,W,W,W,W,W,W,W,W,W,W,W,W,W,W,W,W,W,W,W,W,W,W,W,W,W,W,W,W,W,W,W,W,W
W,W,W,W,W,W,W,W,W,W,W,W,W,W,W,W,W,W,W,W,W,W,W,W,W,W,W,W,W,W,W,W,W,W,W,W,W,W,W,W,W,W,W,W,W,W,W,W,W,W,W,W,W,W
W,W,W,W,W,W,W,W,W,W,W,W,W,W,W,W,W,W,W,W,W,W,W,W,W,W,W,W,W,W,W,W,W,W,W,W,W,W,W,W,W,W,W,W,W,W,W,W,W,W,W,W,W,W
W,W,W,W,W,W,W,W,W,S,S,S,S,S,S,S,S,S,S,S,S,S,S,S,S,S,S,S,S,S,S,S,S,S,S,S,S,S,S,S,S,S,S,W,W,W,W,W,W,W,W,W,W,W
W,W,W,W,W,W,S,S,S,S,S,S,S,S,S,S,S,S,S,S,S,S,S,S,S,S,S,S,S,S,S,S,S,S,S,S,S,S,S,S,S,S,S,S,S,S,W,W,W,W,W,W,W,W
W,W,W,W,S,S,S,S,S,S,S,S,S,S,S,S,S,S,S,S,S,S,S,S,S,S,S,S,S,S,S,S,S,S,S,S,S,S,S,S,S,S,S,S,S,S,S,S,S,W,W,W,W,W
W,W,W,W,S,S,S,S,S,S,S,S,S,S,S,G,G,G,G,G,G,G,G,G,G,G,G,G,G,G,G,G,G,G,S,S,S,S,S,S,S,S,S,S,S,S,S,S,S,S,S,W,W,W
W,W,W,S,S,S,S,S,S,G,G,G,G,G,G,G,G,G,G,G,G,G,G,G,G,G,G,G,G,G,G,G,G,G,G,G,G,G,G,G,G,S,S,S,S,S,S,S,S,S,S,W,W,W
W,W,W,S,S,S,S,G,G,G,G,G,G,G,G,H,H,H,H,H,H,H,H,H,H,H,H,H,G,G,G,G,H,H,H,H,H,G,G,G,G,G,G,G,G,G,G,G,S,S,W,W,W,W
W,W,W,W,S,S,G,G,H,H,H,H,H,H,H,H,H,H,G,G,G,G,G,G,H,H,H,H,H,H,G,G,G,G,G,G,H,H,H,H,H,H,G,G,G,S,S,S,W,W,W,W,W,W
W,W,W,W,W,S,S,G,G,H,H,H,H,H,H,H,M,M,M,M,M,M,M,M,M,H,H,H,M,M,M,M,M,M,H,H,H,H,H,M,M,M,H,H,H,G,G,S,S,S,W,W,W,W
W,W,W,W,S,S,S,G,G,G,H,H,H,H,M,M,M,M,M,M,M,M,M,M,M,M,H,M,M,M,M,M,M,M,M,H,H,H,M,M,M,M,M,H,H,G,G,G,S,S,S,W,W,W
W,W,W,S,S,G,G,G,G,H,H,H,H,M,M,M,M,M,M,M,M,M,M,M,M,M,M,M,M,M,M,M,M,M,M,M,H,M,M,M,M,M,M,M,H,H,G,G,S,S,W,W,W,W
W,W,W,S,S,S,G,G,G,G,H,H,M,M,M,M,M,M,I,I,M,M,M,M,M,M,M,M,M,M,M,M,M,M,M,M,M,M,M,M,M,M,M,M,M,H,H,G,G,S,S,S,W,W
W,W,S,S,G,G,G,G,H,H,H,M,M,M,M,M,M,I,I,I,I,M,M,M,M,M,M,M,M,I,I,I,I,M,M,M,M,M,M,I,I,I,M,M,M,M,H,H,G,G,S,S,W,W
W,W,S,S,G,G,G,G,H,H,H,M,M,M,M,M,I,I,I,I,I,I,M,M,M,M,M,M,I,I,I,I,I,I,M,M,M,M,I,I,I,I,I,M,M,M,H,H,G,G,S,S,W,W
W,W,S,S,G,G,G,H,H,H,H,M,M,M,M,I,I,I,I,I,I,I,I,M,M,M,M,I,I,I,I,I,I,I,I,M,M,I,I,I,I,I,I,I,M,M,M,H,H,G,G,S,W,W
W,W,S,S,S,G,G,G,H,H,H,M,M,M,I,I,I,I,I,I,I,I,I,I,M,M,I,I,I,I,I,I,I,I,I,I,M,M,I,I,I,I,I,M,M,M,H,H,H,G,G,S,S,W
W,W,S,S,G,G,G,H,H,H,H,M,M,M,M,I,I,I,I,I,I,I,I,M,M,M,M,I,I,I,I,I,I,I,I,M,M,M,M,I,I,I,M,M,M,H,H,H,H,G,S,S,W,W
W,W,W,W,S,S,G,G,H,H,H,M,M,M,M,M,I,I,I,I,I,I,M,M,M,M,M,M,I,I,I,I,I,I,M,M,M,M,M,M,I,M,M,M,H,H,H,H,G,G,G,S,W,W
W,W,W,S,S,S,G,G,G,H,H,H,M,M,M,M,M,I,I,I,I,M,M,M,M,M,M,M,M,I,I,I,I,M,M,M,M,M,M,M,M,M,M,H,H,H,H,G,G,G,S,S,W,W
W,W,W,W,S,S,S,S,S,H,H,H,H,M,M,M,M,M,I,I,M,M,M,M,M,M,M,M,M,M,I,I,M,M,M,M,M,M,M,M,M,M,H,H,H,H,H,G,G,S,S,W,W,W
W,W,W,S,S,S,W,W,S,G,H,H,H,H,M,M,M,M,M,M,M,M,M,M,M,M,M,M,M,M,M,M,M,M,M,M,M,M,M,M,H,H,H,H,H,H,G,G,G,S,S,W,W,W
W,W,S,S,W,W,W,W,W,S,G,H,H,H,H,M,M,M,M,M,M,M,M,M,M,H,M,M,M,M,M,M,M,M,M,M,M,H,H,H,H,H,G,G,G,G,S,S,S,S,S,W,W,W
W,W,S,S,W,W,W,W,S,S,G,H,H,H,H,H,M,M,M,M,M,M,M,M,H,H,H,M,M,M,M,M,M,M,M,M,H,H,H,H,G,G,G,G,G,G,S,S,S,S,S,S,W,W
W,W,S,S,S,W,W,W,W,S,S,G,G,H,H,H,H,M,M,M,M,M,M,H,H,H,H,H,M,M,M,M,M,M,M,H,H,H,G,G,G,G,G,G,G,G,G,S,S,S,S,W,W,W
W,W,W,S,S,W,W,W,S,S,G,G,G,G,H,H,H,H,M,M,M,H,H,H,H,H,H,H,H,M,M,M,M,H,H,H,H,G,G,G,G,G,G,G,G,G,S,S,S,S,W,W,W,W
W,W,W,W,S,S,W,S,S,G,G,G,G,G,G,G,H,H,H,H,H,H,H,H,H,H,H,H,H,H,H,H,H,H,H,G,G,G,G,G,G,G,G,S,S,S,S,W,W,W,W,W,W,W
W,W,W,W,W,S,S,S,S,S,S,S,S,S,G,G,G,G,G,G,G,G,G,G,G,G,G,G,G,G,G,G,G,G,G,G,G,G,G,S,S,S,S,S,W,W,W,W,W,W,W,W,W,W
W,W,W,W,W,W,W,W,S,S,S,S,S,S,S,S,S,S,S,S,S,S,S,G,G,G,G,G,G,G,G,G,G,S,S,S,S,S,S,S,S,W,W,W,W,W,W,W,W,W,W,W,W,W
W,W,W,W,W,W,W,W,W,W,W,S,S,S,S,S,S,S,S,S,S,S,S,S,S,S,S,S,S,S,S,S,S,S,S,S,W,W,W,W,W,W,W,W,W,W,W,W,W,W,W,W,W,W
W,W,W,W,W,W,W,W,W,W,W,W,W,W,W,W,W,W,W,W,W,W,W,W,W,W,W,W,W,W,W,W,W,W,W,W,W,W,W,W,W,W,W,W,W,W,W,W,W,W,W,W,W,W